000020000200000000020220000000000202020002200022220022200202002200002000220220000200000000002020000020020022202000002000
002200220002000002222000220002222202022000200002200020000200002000200002002222022000200202002020022220000000000000002020
200000200220002200000220000000000020020202220200000002000020200000000000000002002022020200000002000020020200022000000020
202000200000020020000000020202000220002000020002000000000020200000000000002202000000220220002002202200000002000002000200
000202000000002200220222202002200022000000020000222002200020222020002000022020020020000202022022020020202222000020002020
220200000000000220000020200000002002000000000200200002200000002200000000000200020020002002000002002220222000020220002200
220200020000200022020022020202000002022202022020200222002200002002002200200022000020020000000000200000022000000022020020
222020002000020002000220200002022002000000000022222202000000000220200220000200000000000000000000002000202002000200000202
000202000000000000000000020022200220000002000002200000000002220200200022000000000020000200002020022220002200000200000222
000000000020002000022000220200000020000002000000000000020020002220020020020202002002200002000000000000002200220020000220
000000000220002022000200000022202000200000002000000000200020020222200000002000000020020000000000020202000202000000000000
000002000020000000000200000002200220002200020022202000002000000000220002002220000202020200200002002220200220002200202020
000020220002200002222002002020000020000000202000000202200002020000000020020002002200202200020020002200000000000202002000
000200202022002020222000220000020000002000020220200002200202200000200020020000220200000000202000002002000022200220000000
222200002000002000002002020200000000220222000002000200000020000002220020002000022020002000202022020000002000200022000000
202200000022200000000220200202020002022220002002000000000000002200220000200002220222000220220200020002022220200022020200
022220200020202002000000000200002022000020000200000002020002000000200200002002222000022020000020220000022002000200000020
000000020000200220000200000000020002020000000220202002200000002020220000000002000000200022200200200200000202200002002200
022020220000020020202022000222220020002002000020000222022202000002002000002000222202202000002202200002002000000020200002
220200220020002002000002000022000202002000002202202000000000020200000002020222002002000202200002222020200000022202000020
220000000022202000220000220000000000202200000000220020200000020000002200000000002022000000022002200220002202000000020002
002020000020022022000002020002200220202000000020200000000000022020022002202222000000000000022000022220020002220000020000
200020000222200022000200200020220000000002000022020000202000000022000000200200002222000002020020000000200220002000002000
002022002002200002002000000002020022002000000200020220020202022000000000020002200220022000020002000022020002220000002002
000020000002000000022000022002022202222200020002002022020002200000002200022200200000002222222000220022022200020020222202
020202002000000022000000000220022200022002000200000002000020000202000002000200000202002020002200002200020222200200000200
200200000020000000220020000022000200202200020000200020002000002020000200020002002200020000020002020000000200202002020000
202220002020000202200002000022200020202200000020220000002200000200002000022000000000200000002002200022202000000202000020
000002200020220020020200020002000000222202020000002000000000000000002002020000020202000002000000000022000200000200000002
000020000220000200200022202000200020000000022200002000002202000220220020000220020200000200200000002000200000002002200002
000000000200002020000000002200002000020002222000000200000020220000000002002000200000000000222020200200020002000000220002
220000200022220000200020022200000002000000022022000200020200220000020000222002000002002000200022020000000220002220000002
002220000200200200000000220000000000020002200002200220020222020000020200202000000000200200200020002000200000200000202202
022000200002200002200000000000020002200022200200002220020002200000000000002020000200000200200000000000000220022000020002
220222000000002020000020002002200000000020202220000222200220020020000000202020000000020020020200202202200000000020220000
000200202002020020020000000000222000000222000220000000020002022002020020200202200020000000000200000000202002020000000022
002000002002000200000000002220000200200200200200002200002000002000200000000000220202200000200020002000002002020000000000
020022000000000000020000000200202200200002002200000200002000200000020002002000000220022000200022020000000020020002002020
000000202020002000020200222220002002000002020200000000202200000000202000000000200202000020002002002022202020220000022000
002000022002000222022020000020000002020000200002000002002000202000000200022000000000200220000220202020002000002022000002
000002202200000002000200000202200200020000202200000000000000200200020020002202020022000220200000200022000202022002000000
020200020000000022002020020000202002202000000000000220002000020202002000002020020000020022000020000202002000220220002000
220020020022022200222020000000002020002000002200022220200020000000222220000222002202200000002000000020220200000000002002
002000200222002000220000000002000200002020200000202000022200002022022000020000000000202222022200020002220000202000200220
020002000020200002022000200000020020200000222020020000200002000020000002000000220002000000000002002000020000002200000202
020002000020020002002002002000200220002200002000200022220000000020020020020000000202200022002002000000200000200020000020
022000022200002022020220022000220000002000020000000020002220020000000000020200202000020200000000000000202200020000020200
020002202200200020200202200020202020002020002000222022000000002200020020022000002000000220002222000000000020020022202000
222000220022000000220020200000220000222202000002220000020220220200000000200202200000020000002022000002002000020000200200
002020000000220000000220202000020002000000002000000220020020000022002020022002000000000020000000000022000002202000000000
020000200220000000002002020002022002000020020002020000002002000000222002220220000000002200020000022002000200000022002000
020022020022000000000000020002000200002200002022000002020000000200022000000020002220000222220002002022002020000200220002
002200000020202002202000000000000000000002220002000202020000002000000020200000002002200220020000002202000220220220000000
000000000000220020000200000002000020200000020020000000220000000020000200000000020000000000000020000200000022220200020000
000022000002000020022000200022000000000222000000000000020000020000000000022200000202000000022002000200000000200222000200
200002000000022002000200202002000000000002020200020020220000200200000000002002000000002002020200200020002000000002000000
020020202002020000200000002200000000002020022002200000022022002000000200002020200020002020200000022000002002002000200000
202002000002202000020000000000200000200000000202202022000000020002000002002000000002220000220200000220000200000202220000
220020020002022020200002200000000200020200200002000220202000000000222022220022022220000000022000202200200002200000002000
020022000220000000000222200200000202202200002000000202000200202000000200020022020000000220200000200200200002000022000000
000020002000200002220200000000000000000000202200020000000220002000000020020000002020000000020200202000020020000000022220
000020200200000000200002002020000220200220202000000222020002000000020200020020000022200220202000220020020002000002000200
220200000002020200002200200202002000000002000020202002000200020220200220000000000000000002000020000200000200022020200000
202200002200002000200000200000000002200200202002000022202200020020200000020020020002020000220200000000020202020200002002
200020200020002202000000002000220222200000200202000000200000200020200202000002020000022000002222020020002002020022202200
002020200200200000220200000020000200220002220002022020200200000022220000200020000020020002222000200000200000000000000202
000002000022220000020002000000020000200020000202020000000002000022000000000020002220202020222000000000200200200002200002
202022000002002200000002020000200222000200000020000200000000000220000020002200000000022020000002000000020000000220220200
020200220002002002020000020002022020000220200200220000000020000202200002200000020002220000020020000000000000000200020000
000000200200002000000020020220002000202020000200002200200220220002002002200220000202200022220020200002000202202020002000
000002200022020000000022002000022000220200020000000002220022002000022020202020000020002200002222000000000020022000000000
020002002020200202000000020000020020000220202200000020000022000002020220000000200002022020020020000202020000020000002220
200000000202020022022002002202000020000002000000020002002000020200220000002020020002220002200200000020000222202200202002
000000000020202002000220202200002200202002020220002002020022200000000220020020200220000002222000022000022000002000000020
002220000020000000020000000000202000000022002200222220002000002002220202202022000200220020200000000222222020002000000022
200020000000000000020220020200000000000000020200200000200200020000200000002002020220000202000000000002002000020200222222
202020020000202000200200000020222000020020020000000200002000220002000000022202200200020000020000002000002000002200020020
000002000220000220000000000000020020002002200002200000020022022200020022000022000002002000200020020000000200200020200200
020202020000000202000000022000022022000000220000002022220220022200000200020202020022200220202000022200000020202000002000
020000202200020000000200000002000200000020022002022222020002002000202020020202022022020020000220000000220200000022002022
222000000000000022000200000000020002220200020000002020002000000000200202020220000200002020200002000000022020220002000200
002200002020020000000022020200020020000002200020020000002020002200000002000202200000002202222000020020200000200200020200
000000020000002200000002002000022002200220002000000000000000202000000200022000020220000220200000002020202020200002000022
222020202022020200220220000002002020220222022222000022000000020002020200220220200220000000202020020200220000000200002220
202000000200220020002000002202000022002000000202000000220002000020220202000220020022222002000202000002000022000020020020
000200222000002220000000000000000000200000000200200020000200200020002000200020002000000000000000000220000000000220200000
200000002200220000000002020200002002002000020000000200000200220200200002220000020222000000000002020020000200220020202202
202020220000000000000022000002020002000200200000200022020020200000022200200000200000002200000220000002202002000222000002
000000220002000000200200000202000000000222020000002202000000000222000002002220022200000000000222200020200020002202002020
000000000020200022200000020022000020020020020200000020000000000002200000002002200000022220002000000022020000000020020020
220002000000020000202000200020002000222200002000000200000202000000002200022200020202020002022000000002002022020220002220
020000202200220020000000220000002200202200020200202000000000000000000002020200220002200200020020222000200020020000220200
022000000000200002222202000200200020220002220000002002200222202220000020000202202200020200002000020000000002000002000000
000200220000020002000000000200202200000002020000020000000020020000000002000202002002002200022020220202020220202200000020
000220022000002200000020002000000000002002220202022220020220002000000200002020020220000202000000000222000000222002000002
000020002022000000000002200002200202200000020002200000000000000200022200000000200002200002022000222002022200022002200200
000202000200000020000020000200000020200002220200000222000000002220002002022020200200000000002000022020200202000000002000
222220022220002000020000200000202000200200002002022002000200000200200000000220200002002002022000000002020000200020002002
002220200200000022222020200000000020000200000000002000000000020002000002020002200220200020022200022000000022202000202200
200000000000220020200000202200200002220200200002002000000002202222202200002000222000200200000002000000022000000020220000
200000000020020000000022020020000220000022000200222002000000000000000020000020000020020000022000000202022200002000020000
200000002000022200000002222220000202202000002000220202000000222000202000000200000020000020000202022000020200222000200000
000000022020000000000000000000000220022000020002202002000000020200000202000000202220020002020000020022000200020202002220
000200000020000202000000200022220020022020000202020000020002000000002222202000002000202202002202220000022020002000000220
220020022000220000020002000000020200002000000002000002000002202200020002020000020200000000002202020202022000000000200022
022022000020200000220000000200200000022200002000020000000020200200002220002020000000000002020002200002000002020002200020
020200002000000220200200220002200000002200002200200000002200202200020202202000200000202002020000000002020020000000002000
000000220220000000222000002200002220220022200000000200000000000002222000000000000000200000002002020202000202002020000000
002002000002200220200020202200002002022000022002000020200222200000220200022000202022220000000002000020020002000220200000
000000000000200200000000000000000220020220022002200022200200000202020020000200002002022000000020002022000000200000000000
002002000200200220200000020020002220202020200002002000002202202002200022000000000000200022020020002202020000020200220000
022200000000000000002020202000000220000202020202200200200000022020020200020022000000222222020002000020020000000020020200
022220222200002022200200222202000020000200002222200200002002002000020000000220200022200200000000002020022002000000000000
020020000002020000020200200000202000000000020002000022222200000002022220000000020020202020000020000000000000200002222022
020022000020020000202000002000020222000000020000000020000002000020002000002202000200020000202022000200002020000200000200
000002220220000000200200002000002000202002000020000022200022022022200200002022000220020002002020000200000000002002200000
200220002000022000022200000200220202000002000202000002020222020202002000220000020222000200020202002022000000000000002000
020020000000200000202200000020002200200200220020000020202020200020020020220000022000000020202020000020020002000000200000
000000200002000000220020200202020020000202020000000020000222022200002000022022000000200020002000200000000220000002002202
002000000000000000002002000020200020020000020222220020222020202002000200220000002200020020000220200200002000000022000000
