02020000000000000000000000000000000000000000000000000000000000000000000000000000000000000000000000000000000000000000000
000000000000002022000000002000000000200000000200020000000000200002000000002000000020000000000000000022000020200000000000
000020000000020222200000020200000200000000000020000000000000020000002020000000020202222002000000000020000202000000000000
000200002000002020200020202020000000200020002000200000000000202000020200000000002022020222000000000020200220200000000000
000020020200020200020202022200020000022000020222000000000000000020002000000000000202202222000000020002200200000202000000
020202000020202000002220220020200000002000000000002000002000000000000000000000002020002220202000202002220020002020000000
002220000000020200002222022000000000020000000020000020000200000000000202000022222200002202020002020002000002020200220020
000200000000200000020200000200202000200000000000000202020020000020002020000200202220220220202000200020020000000020202002
202200000000000000002202002020020002022000000020002020000000200000022000000022222200000202020000000000000000000022020000
000200000000202020000020202000200000000200000022020202200020020200000202002000202222002202200000000000000002020200200000
202022000002020202000202200000200000202020000220000000020020202000200000000002020020222222000000000020000000022022020002
020222202000000020000202200000020000020200000202000002222202022222000000000000220202222002200000000000000000200202202020
202020000002000000000000220000000200202020000020000000200000202200020000200202200020222222220000002000000000020022220202
000002000002202000000000002202000000000200000000020000020000222000002002000000220202020002020000000022202000202000002020
200000000002020200000002020000200000022020200020200002002000000000200000200202022020002022202000000002220002000000000002
020200000020202020000020200000000000200202020000000000200000000202020020020020200002020002020000000000200000002202000020
200000000000222222000202000000000002020020200200000002000000000000002022220202000000200022202200200002222000020002000002
000000000000222220000000000000000020000202002000000020202000000000020022222222220000000002000022220000200000002020200020
000000000000222200000000022000020200002020200000000002020200000000022202000000200200000000000020220000000000020000000202
000000000020222200000002020222000202020200000002220222202000200000202220002000000022202000020200000020200000202200020222
200000000002000022000000222220220020202200200002022000000002002020000202020000000200020000000200000000000200022020202000
000000000020020200000002002222222200220020022000020202020000000202000020002200000002200002002000220000000022222200000000
000002000000000020000000220000222000022202000000002020000000202000002220200020202202000020000222000000000202022000000000
020020200000000000200002000202000000202020202200020000000202020000000202000000000020002002000000220000000022000202000000
000000000000000000020002000020200000020202220200000000200000202020000200000000202020022220000000222000020020000000022020
000020002000000000202022000202000000000020000202000020020202020000000002000000020202222002000200022000000002000202022200
000002220220000200000202002000000000020202200022000000202020200000000020000000202000202200000000020000202022002020222000
002202020002222220200202020000000000000220000200200002020200000000020000000000022200020200000000220000020000200200020000
000222200002020000000000000000000020000022222222020020200020000020000000000000202000202220202002002222222200202000000000
000002200000202020000022020000200200000020202000220000002202000000020000000000020000022020222020220202222022020200020020
000020200000000200000200202202002020000002220202020002022020000200202220002000000000022222222222002222220202202000020000
000200000020022020000022222000000200002222202020200000222202002200020200020200000000202020222220002022222022020200020000
000000000000000000000020202002000002220222020222222002022220220022220000202020000000020202222200000202022220202202020200
000002000000020002000200000000200022022022222020000200222222000000000002020200000000202022222220002000202222220000202000
200000000000202000200020000000022220222222022222000002222000200200000000000000000000000002222200000020002220200000000000
020000000002000000020020020020002220222220202022200000202002022000002000000000000000020000020202000002022202000000000202
000000000020202020000220000200000002002022020022000002020000000000220200000002020000002020202020000022022020200000002020
200000000002020000000200000020000000022000000002202000002000022202002000200222020000020202020200000002202200020000000002
200000000000202202002000000000020000002002020020020000000000202022202002020002022200200020022020000020000002202202000020
200000000002020000020200000000002000020200200200022000002202020222000200202020200200020200200202000000020020202022000022
020002202020000200002020000200020200002002000002220200020220000000000000020202000000200000002020000002200000202200220002
020002020002000000220000000020202020020200000022222000000000000000000000200022222000000000000202000000000022222222020222
202020202000202000200002022220020200002022000000200202020202000222000002220222200000202000002002000002220202200200002222
000220000020220000020000002202202000020200000020002020222020200002200000020002002000000000002000000000002220222222220220
022220220202000000000000020002020000200000000000220200200000002000000000202020200000020002000000000200200022202202002002
202222020020000000000020000002200000000220000000000000000000020200000200020002020020202000000000002000000202002020020200
020200000002200000000022020222020000002200220000000200000002020020202000202000000002000200002000000000000020220200022020
202000000000000000000000002002000000200000220000222002020002220200020000000222020222200000000000202022000202222020200202
020220000000200020000000020222200200200000020000020020202002222000200000022200200000002200202002220200000020200002022000
000202000000000200202020000200000022002000000002020202020000220220000020002022020000020022220002000200020002000020222020
000020000000202002020200000002220200020000000000200200222000200202020000020200000000202022002020202000022000000202222200
000002000002022020200220202002220202022202000022020222220000202020200022022000002022022220200000000002020200002020000000
000200000022202200000202022202200000022000220222202200220000020000000002222000200222222220200000002000002020020202000002
002022002022022002020220222220020002020222022022020000020000000000002222200002022200000202020000000000000200202020200020
220000020202200000202200022220220000002020220000022002200200000000000222220002200202002020200000002000000002020002002002
000000002202000202000222200222222020220022020000220000002000000000002022202002002020000200000200020200000020200020220000
202000000022200000000220202222200000020200020000002020020200000200020020020200000002002020002000002000000002020002200002
020000000202220202000202020202000000002002202000020002022220000002000002202000000020000202020200020200000020002202000000
000000002022200020200000202020000000000222220000000000202000000000020000220200000000020020202000202020000202020000200200
000000000200220002020000020200000000002002222020020000020000002000202000200000000000200000020002002002000020000200202000
000000002000000000000020000020000000000200000200002000022000000000020200200000002202020000000020000000200002000002020200
000000000200020000020202000000000000000200000022020202202220000000222000002020222020202020202002220200000020000020002000
000002022200200002022222022000200000002200020002002020200000000002020200000202220022002200020020222000200002020202000000
000000020002020020222222222020200000002020200000000000000000000020222022202000222220200220002002020200000000022020000000
000000002000220002020202220022002022022202020200002020000000000202022202000202002202000000000000202020002000222000000200
000000020200002020222022220200220200222020200000000000000000000020202020000000000220200000000002020200020000222000000202
000200202002020002020200222000002202022202000000022000000000002000000202000002020202000200000000200200202000020000000222
022222220020200020202020020202000020202020202000200000000200020200000220200020202020000000000000020000000200200000000202
000202200222020200000200022022200000020200202000002000000020000220000020020202002000000200000000220000002002000000000020
002022020000002200202020020220000020002000000000002200022200002000000002222020002002002000000000200000000222202000000002
020000022200220000000200222222000000000000000200020200020200202220000220220000000000020002000002000000000020002020000000
202000020000220200000220000000200000200000000000000000002220000000020002000000000000000000000022002000020020002020000002
020220002000022020202200002000200200000200200000000000000002002200222020200000000000000002000002020000202002222220000000
202202000000000202020200000200020000002000000000000000000020200000020022020000000000000000000000200000002220202000002002
020020200000002020200000000000220000002220000000000000020002020202000000200000002000000200000000020000002202020200020200
200002000000200202000000020000000000002220000000002000000020202000000020020002000000022000000020000002220000022000022000
202000000002022020002000202000020200000020000200202002000002020002200000000002020222200200000002002000222020200000020000
220020000020220000200002020002200020200002000002020000000020000020000000000002020202020000002002000202222022000000022002
202002020202020000022020022200000002000000000220200002000000020002020000000000220220000000000202000000022222020000220002
020022000020200020200022022000002022000002000000000020000000000000000000020000222200000000000022200000000222000000000002
202000020202000002200020202202000202000020200000022022000000000000000002020200020002020000000202020020002202002020000020
000000000022022022002002020020200000200002200000202200000000000000000000002022000000202020000020200200200000000200000000
000000000200200202020200002200000202000002202000020020000200002020000000020200000000020202000202000000220000000020000200
000000000002020020002000202020000020002200022200022220000000200202000000002020000000222020222020202000002000220200202000
020000000020200020002020000000000000002000202220022020002200000000000000020200020000200202022002020220220000002000020200
000000002000000200222200202000000000020220202202202000000200200000000000022022022200022020222020000002202020000200002000
020200000200000020200000020200000220002202020002020020000000002000000000022222222220000202022220000202002000202000000220
002020002000002200200000000000000002020220200020000000000200020000000000002222020200222020222202000020000000020220000222
000222022202020000000000000000020202220002000000000220222200222000000000000000202020000002022200000000200000022220002020
202022222020200200200000000202202020000020202000200222022002222200020002222000020202220000202220000020000000000020000020
020222222222002000000000000020020200020200020000002020020202220000002022220000202020002022000202002000002020000002000002
000220222220202000000000000000000020000200200000020200000202222002200022002220002022020200202002020000020202000000200020
202222220222220000202000000000002200002000000000020202000020020000000020202000000222222000020000202202020220200002020020
002020202020000000000000000000022020000000000000002000200000022000000002000220002022000000202000022220220202020020200002
200222020202000000202000000000202202000000000000020000000020002000020020200222000020000000002020022202000020000002020022
020020022000000000000000002000020020000220200000002000000022000200202002020220000202000002000202002000000200000020200000
000202020000002020020000000200000000000022020000000000000022022220022000202202202020002020202220200200000020002200200202
002020000000000000000000022200000000020222202000002000000000200002020200020020020200000022220222000000020200020222202000
222222000000000020000000002220000022222020220200000200000002020002000020220222200020002002222222020200202000002020220002
002222020200022200020000000222000202020202222002020020000000000202020000002022200000000200002022200002020000000202000000
220002222002020020002000000020000022202020202000200002020000202022220000000022200200200000202202000000200000002000220000
000202220020200002020200000002000022220200022002020000200000020200000020000022000000000002022020000000000000200200200202
002020000000020000202002002000000022222020220000202020000020200020000200000222200000002020000202020000002000020000020020
020202200000200002020020000002000022220202222020020202000000000000000000000020000000020200020200220000000202022200220200
002020200020020000200022020200202020002020202000202000000020200000000000022220200000002000002020000000002022200020202002
020200000000000002002000202002020202020202020000000020000200000000002020000000220000000200020200000000022220200002020000
200000000020000000000220020202220020202220202000000022002000200002022002000002000002002000202200000020002222000000200220
020000002200002020002220000002220202222222000000200000020002000020200000202020000000200002022200000200002020200002020220
202000000222020002000000000202222002222222000000020000000020000000000202220200000000020202000000002000220200020000220220
020200000000202000000000002022200002220202000000000000000002020002022002000000000000222222000000020202222222000002022220
202020000020000002000002000200200002202222000000000022000000200000220202000000002000002222000000020020222220202000020020
000202000002000000000000202000020002022220000000000220200000020000202200020002020200022220200000002002220200200202000220
020000220000000200000002020000200000200020000000002022020020002000000000000222020002022222000000020202020020022000200000
202020200002002020000000000000002022200000000000002000000222000000200000020220000220220020220200002000000000020202020200
002020220002020202002200000200020222200000000220000200000202002020002020000220202200200202000020220000000000000020202000
000002200000202002020200000202000020020220002020202200002020222200002202022022020200222020202022020000020000000002222000
002000000002020200222220000000000200202202020202202000020202020220220200020202220000200220002000002200222000000000222220
020000000000002002022220020000000222000220202020220200002020020202000000202020002200002202022000220220020000020200000000
002000200000000020020000000000020020000000000000000020000202002020000002020220220200020000200200020000000000002000000000
000000000000000000000000000000000000000000000000000000000000000000000000000000000000000000000000000000000000000000000000
